ftv: jhc jdt jcr knd
kbf: jkv rjl gnj nlm
bnn: hxj jks
vqs: qcp
rlg: bdl
tfk: bcb
zxj: qsr gzl vgf lzr dvm
cvc: mpn
zxz: llt jqq nbv
kkb: htq
gss: mtg
lfm: cqb gcb pnf
pfd: vsz dxk gkq mcm
pmp: tjl
szp: glh nrr
gqh: pvq nrc grq
cbk: qjr mpn
xbq: sfr
cbx: csc djr xjc
gdx: qbz
vpg: xgq lnd pkb
pvp: mfs lfb bnq pdt
kzn: hmj
qcm: brv jcl rgd
jln: qqt pcb mdx blc
sbr: lzn pzh
qhk: dhh xqh tgp
sxr: gdn mjt mtx
mhp: xpt xsf djh vpm
xbh: jxp btv zpj jxx gbx
lvj: pll bfh
rdj: ghs hvf lbg
fvr: fjn tcc lls gzl
nll: ddh ncr pgk xvq
ptg: txv jpp lfv ttr hrx
jdf: sfv xzs qmh vnc
qfk: sfh
dqp: jlx djc jxd rfd tgp
hzd: xqr mzx lnp
sck: hqq pmp qqf vjk
jkx: tbr srl mdx
gjx: cjg xzs
hqp: bpq mkc xqg pzs
sdj: kqh frn rvv hhq
ksb: sfh frn nlr nmc gdn
kmq: hlc
hvf: lbg hjb dsd
zgd: lhz
dhh: bcq
nml: cbx
mfh: gpb vhr cpv gsx
kgv: jzc
pbz: nmn mqx kxd
gts: lgp vkr fgk
vth: xvq
tcl: jrl ghp zpl
zkv: zch bfv krf plj
gvq: jjl rsj
zkq: gpr
jdt: kkb fjz
zzv: lfq xjc crd ttr
xhh: lzh gqt
zpn: fzq gfq fdx xrg gts
cxq: vhc txv nsb
qmh: tpj
mcm: nff hcd bpq
lxn: nxs pqp
kzp: cgf
tpl: bzn szc llt dvn
tpv: nmk
zrn: fvv ppm
cpb: btk nml
qlx: xgx zxx khb dvk tgp
fmf: vsh rrb qhp bgm
pnr: rjl
slq: zjb hfz xhh
kjc: csq npg
rts: ghs
qdg: qtv cmz pkb ncd
kvf: nmc kvn vrb
qgt: rbc pqp sbz
xzz: xng kgl cfm
vmr: vmv rcv pbz tfm sqd
fpc: nvf hrr gmf
dgh: ddf xmb glh bsh
grq: bgd fsv qtd
ggh: dzg zdk
psr: jcs
brv: ndd
gqv: cpb hxf bqc hcd
xgg: ztp flc
mkc: gxv mlv zdk
knp: mht sqr xkk
khl: kfr cqb nmk gmb
bqh: rgd
szb: gxb lcs
xvz: lml
jdg: kbb
zpd: bnd fvk
mzq: rtb nmn
cqb: xsk gfq
vjn: ltv smd kgc
vgd: pzp zvd sjd lnd zdc djp
fnm: zjb fqx pkb
nsk: xqg hbl lzn nmk
bhl: kcb dnb mtz
rph: pbb
crn: glj mps kmk vfx
bmq: lgn qlj
jck: dpv xqk
xdb: sfv bzg
qdk: sjx lpq pns kvd
pbb: tql
rhg: glj
zlq: kpd
qnl: knh csb cjr pcb
jrg: xjc nsb
dsd: dqv qll cxk
pgm: jcl rhv jhz
kbb: cjg fpk vvb
xbn: vrr znf lvx rtg psb
xgv: kvd lbg gmq bmc dpv prk
gqn: mgg
zhc: jfc zqx bxv kkp
ggk: dmc hcn
btl: lcq gmf
cnc: gcg fsv lnk
jqj: hgq
hmt: gmb rkt mlz dtp
flf: bnx ltg qll bhg
fkf: hbf pgm xqd lnd
xph: bhk lcq rph xsp
xmx: nkk pqc
tgv: rhg szk
pxv: mlm mtz tcz mlj
kxd: hgq zrb bpq
qxf: csc lml xrc
ntn: fjp fjx jns cxk
mbg: trz hrx zsm bnd
pzg: qpp sjf mmt pqb lfj
bfb: bcq cph qfb
jxd: fhd mkc jsf
xzx: qhv rrj fnz
vgs: jfg vdg jsr knb
vtn: xrq nmm kjp vvm
fzk: lnd qgz gjv
lpq: xdx pff
vch: lls psv gmq
zdx: xbn qpp pzq zrn
lkz: zjk ckh dfv jdt
hrd: hxf vth blf hxp cpc
dtm: nvs qgm lmv dvm
ndp: xnm
xsk: tnt kfr
pxr: bnx lhl vzs thv
qgg: tnr
knb: zpv zmb vxd
gmf: lnd
grb: flc
tct: mgf jns cbt kkt
tjb: htx
jhc: xnm
qtp: rrb xzc bvp
xxx: nlh vrb blf xcr
jcg: bzz btv flc
crm: xng
vdj: pgk kvx
bcs: lzr hvq rvx szk
rjv: xzx kfr glh bvn
bmx: qjr
snj: cfx vvt cqm
kfc: nlr
bll: xtz xjd fzn
mhg: cnn pqb fnz fhv
rlj: rgl lrr tjb mps
lmv: zjk xsh tjl
crg: mdl
bcv: zjx
fhd: nsb bzg xrj gxv
vxd: bcv
dcl: xrd
lxg: kjq tvs djh cqh dsl
fvv: plj bzl vhz mlm
bzn: tnr tkx
hzh: qvk dvl ccl
cmv: xmk
psn: fqv hmb llk
zdk: hqz
cbt: mdr dsd cvx
nqq: gqs jnp zfv vhr
clv: xgg mkr
gbc: jrg ggh rbr qdt
fhv: sqd
jcr: gxl
qgk: brn fgt dxv qlm
rxr: kkp dnj vpp rvv
bfd: vqs sqd jqj mtz
qbf: ddx vkd jxx
nvf: mps
ptk: zsp cpm csk kkh qss
bkm: bbr tpk lbq
xrc: gcb trk txv
qtq: pjv
khb: bkp dqk zkq rqj
ggg: tsz tbj scx
lzh: gds
mrj: pfr qzk jfl pzq
pgx: trk mtg pzh btk
zvf: gmf
pkl: hmj qqq gst txc
pzh: hmb gbl tnz
xvv: zkq rrh hgq
ptr: mfx qvp ztp nvs
hjb: vpg ztp
bgm: zpj
qvn: tnt zch
tzl: fbk cbd vkb lvj tfm
zbh: dvn lvv pqc trf mpn
lgl: mlm gfb
cpc: dhm fzq
vvm: lgp
xpr: dmc
ftn: fbv xjc vdh
mps: gqb
vql: fjm ltg djx
gmv: zgx xzc xsf
jkq: mzq rvv svm rrq
pbs: mnp csg
zpp: mks mfg xlq
hxq: vmf kkp hhq ftl
ssf: fkx fzt
psj: xph gcd xbh rfm
bqb: tcj fgb lvj
cjp: gmq fqh vxd qtq
djt: hxm gqt
qcl: mpt qjg xph ksk
jlv: srl rgg hpj bfh
ddh: mnk
vgf: bcb mzt
bkp: vpp
mhj: gzx zfl pbb csl
mpf: xmq nff
vdh: tcj pnv
bjq: cft rls sjx hmx kpq
hgk: fnm njz mfx
qlh: hrr plm nkj
skm: rqh ght bdh hmt
kfr: mlv pnv
xzc: szc
vgm: fzq qbz gcr
kjp: prz mzx
csm: csk vqs
fnl: lqs lbk gjv pfh
pqb: csg
ccx: jxx prx pzp tjl
grl: kgv dgm vcb jdg
rxb: lhz xrq
mfk: jzv fpk
fqj: nnd fjp bll xlq htx tmx
trs: vmq xkk fqp
gcl: zkj rsj nmn ddh lmq
kqr: gbt szb xdb
vgb: jjl lml djr
ltr: nhz fmt bll bfk
qtd: ghm ccv
zfv: xzn
lqk: bkp xvz szp dxk jzc
jcl: nkj ckh zjb
bbm: nlm fqp
prz: nff
njz: cbm zfl
lsv: jcd cbd pcb sfv
mst: sqr sjx trs mfg
jcz: nrn bsh
hxp: kqr gpr
hjk: njx rxb
qnm: jrm vtj qlh rrb
xld: jhc zhj qqq rbl
qkn: jsj ccv
kgc: tts
qcd: kcf nmm lfv
nrg: kpf
zfh: hsg mjt khj sfr
vxf: dqd vhc dkl
tkx: tnp
lfv: pql tpk
njn: khb jcd ksv vtn
hxj: kpf
rnx: gmv zjn xzn xbd flf
njx: ltv
nqh: bkx mzq ckp
gcs: bfb fvk tvz
rzh: tbj vvd dnb xkv lrn lkq
lfs: vch dvm pns ptp
gsx: bhk tjl jqq
tcm: xrd rhs gtp cbt
btv: csq
clb: zlp grr
lqg: hmx
qkk: gfk ccs hkp lzr
hvb: vxf pfr pql
fdl: snj nqh tpk slx
rvx: zhl lrq ghs
qkf: mzx bbr jtl
krn: kpd crg lcq
fpr: gqm
brh: jlx rlx rrj jcz
kzj: bgt kdm nbt fsv
qjr: nnd
frl: tdj ggn gnj kcq
str: xhh xmf pqc
rnl: blg zkj cjs lgp
plj: tnt trk
fff: pqj xqd ksn drz
gfk: slq ndp
glh: xmq
gfq: kcb fvk
pdq: pll vdh cxn jfl
mfm: vqs mmt
sdd: fkx rph grb
jxp: pnr
zmb: kpq gfz gxl ddx
mxc: hqq
pgk: qmf
flg: xcr vdj pdz crd
ksk: str nlm xmx
cph: vrf mfm
tvz: vjt cpf kkp kqn
tcg: xxc mfk mlm dpz ftn nmc
rgl: zhl pqp
khq: kcb
vmx: vcb fhv
stj: rrb jmk
ddx: ngc
bcb: bfk
zxx: qfb dss
hmr: jck bqv zdc gds
jrz: vmv ffg tgp pqm
pxf: lkj dmc jsj tjb rrb bld
plv: nfq jnj hxm
gtp: xdx
bzl: ght
tdj: rjl zpv qhp
trg: crf tvs
lzj: hqq lcq
vmk: xtz drh jtq llt ccv
vkj: blg fqr sgn lgl
fjf: lzj hvk
vvb: bzg kcb mjt
cgp: djc pvj clb vkb
llb: lxn
lxf: tmg fvb tnz blg
qvr: vnl nqq prv xsj
fpq: qkt sqp hqz
lrn: qvn hst hxj
fsc: nld zdb gzb jfl
dxv: kqq
mtx: rtg
stn: bhd srz jmx mnr trg
xrj: kfc zll krd
zgq: npl tmc ttl hcn
khg: xmx gnj ngx gjv crm
kpn: jqj htt
pqv: pnv smd
vfx: gzg ndd nbv
zdt: psb chk lvn tch
qkt: tmd vvm
kvn: xsx bkp
hjh: zqx cxn hgq
fzn: lqg fkc
fvk: tbr sqd
chk: dgc gfb nmk
gnm: vnc xmb dnj jjl
kjq: nxs xcd
rjs: qxt
dtq: cgf
pns: mgg mrh kdj rls btl
ssp: pqp npg
vjp: dvm
rhm: xtl cts jxx xnl
jsf: slv
mqm: gjv dnm htx
gbl: nck
kxk: mlj tnz khf
qkb: xrc jmm nrr kvn gvq
mrh: npg gqb
czd: gbt ltk cxq bnd
vvd: kqp glh
tbc: rjl jqq ptp
cbj: ppm tqj jjl
fjz: vlf psv sjx fjn
gcb: mlz dnj
qtg: pxx jcs
kkt: xgg pvq zpp
zkj: ghp
kzx: vrr bcq fqs dfc
zqg: qmh pxx qqr bvg
rpc: rbr ldm gkj
bcg: bpr xgv
crz: rvx
rzt: zfv xhh btl qjg
fpt: dnb cph vmr gvq
fgm: qqq kzb ngx lqs bcg
qxh: tfj pzh zdb zsp
rqd: mdl tbc jcr tvs qtq
zqx: qcd ppm kcr
rkk: dqp hxj ssj fnz vmx
gkq: xrq kqh qbl frs
gvx: qgk xmb glh cfx dxk pql
fjx: hvz
vcl: ngg lkf lcm mpt
zzs: zkj dpq fjc
ldz: mpn knp
zlx: pnr hvk
vfv: ghp
snr: trz hvb hzd hgd
zhr: jzv kqr svm zrb
qtx: mjp dtq rpm
dzf: qkf kjp kqb jcz
ggl: cml ttl zvd kjq
jpp: nrn csk
xgk: cmv dzg
mgm: mzz brn sqd srf
crd: vnc mlp vjv
kbt: fmv zcr tlk fjf
kcq: cxp jkt
bgt: hkf
vkx: chk kcb
qbh: rrh khf kqh mpp npx
pvq: cxk qjr
mzt: mgf xrd
svm: vvt rmk pll
zqf: crd tpk bvn lgl vgb
jfl: csc
pvd: xvz nmn gbt qfk
tcc: pms lzr sdp dmd
xsp: gzg mnr rhg
zfr: lcj vnl dcl xtl prx
npx: tcj
ngn: fhz gcd lxr fnk
fbv: gss
qvk: gmf
brn: tts
pss: bhd qtx dvl
zdb: gfb
pnf: srf zkv xqg
rqj: cnt
dxz: tjx rhc kzp mnc
zth: fjm vmq mkk qhq
pkz: krn vkd zcr
cxl: ftm zxx pql
znb: jdg pnc hjh vfv
ldm: hrx hth pbs
jrl: nmk tcs
tlg: lbq bjd zgd
mkr: djp lqd hcn
mtf: mkk
vkv: bbm bqh cbm mhp
xhv: cjr bxv pfk kcr
xsj: rgc gxl ssx
rgg: xrc ssj zpd jkq qhk
zjn: sgc crf
crl: lhl
bsh: tpj
fhh: cbj lnn bqb
xzs: gxb
mbp: pzr zhl vfg cvp
gfx: cfc xzc
jsr: glj jmx
grj: fsm sgc
trf: bjp glj zhj tql
mxg: djx llb zlq zvf
prx: zxs vfc djh
trz: hlc
mlm: khf
qdt: xcq
jjk: pfr lfq mnk
sdz: jsf cph kgv
lgn: khc hth
bjp: npg
qsq: jhm mtg qrq jcd
bxv: nck cvs tbj gxv
xmb: cqb
fzc: hfn rjs dhm
cvx: dml qgg
cfc: dcl xsf
blf: dbb jlx krd
vlf: bnl tfk
xqr: kgv rrq pfc kkh
gzb: blg dhm gfq
tmg: clb cdh vvt mbg
qqt: zfh mdx pfk
tdd: jhm vjn gbq bgp
gnz: cjp rts bhd rhc
rpt: tbf mfg
ftf: fqp xrd rhg
kkl: cbb
pnc: tnz kgl
qgv: cld rgs bjc zrn cpf
vgq: zgn ftr bpr
rtd: vkb dgm tsz hrc
mbn: mtf zkp hlg brp
dmd: lpq
pfc: nrg
zqm: sbz fjm
dhg: blc vrb clb kpn
rrj: jkx tbr
npl: vpg mks
qpf: brv xmf rvx xnj
slp: cqh vgq zds drz
rhs: xnm ccl
mpd: mkr hqr hlk bhk
lfb: jrm
hfz: zpj
bnq: hxm zcr
dds: qzk tlg pnf sql
dpv: zxs
kcf: qlj
pxx: vpp qkf
jsg: mhs txv
txj: cbb
rpp: fjx fhz cnc
ffg: mtx bbr kfc
dgc: tcs qdt
pzr: bhg bnq zxz jtq
tcz: krd hrx
tqs: crl hmj
qlm: cxn xcq
bjv: nsq btv nkj pxr
vzs: mdl xsf xnj
rmk: vjv
mgf: cbb pfh
gjb: fjx vjp xkk rvx jxk
bct: hbg dfd pvr
gmh: gpz hhv drz tcq
xxc: njx xrq qfx
csb: prz vnc
nrc: lbk
kxr: gjx kkp
qzm: mht nhb qcm stk
xzn: ngc kdm
dqd: zsp vkr
hhv: cbb mfx
cfm: sbz mdl lcm
nlv: bcg tqs lvv cbb
gpz: ztk htx hvz
jnd: tfm jsg lcs
hsg: jkn mnp
hcd: fql vfv
frn: qxx
xmq: tts
hrc: pfc lfq jkn nck
khj: snt bfv cjr
bpr: ztk dbf
nnr: rhs rdj cvg jcg
ksn: bmc dtq cbk ncj
dqk: qfk fpk
ncj: tbf ktq
cvg: gqn zcr xpk zfv
kpc: znc zqm
rcf: ztk stj ghm tfk bmx
rjm: rsj slv tvb
mmx: gpb mtf hsx
ttl: hmx nkj xng xbd
tvs: bgd fkh
llv: pvm lxn qgm
qvg: xrj kqh psr
rkq: mnk tts
qxx: hlc pfc ght
fts: lmv hxm mtf
jsj: ltg vxd
bzm: pjv
pjs: qvk vgf czv gqt
dmf: zhx pzq jrl
ttp: dbf gds zqm hfz
mvt: zch hqz cnt
bgb: mcb mdr
tqj: lfj
ssx: xdq lkj gqb
ncd: lbk fmt zpj jmq
qvx: jkt fkx qvt
stk: lgj pqp bcb
ncr: kmq zqf llk qbl
xxq: ddh cbx hqq dzg
bhd: dpv djp
btp: bvm nml kgl bbr
cvp: glj cml psv zdc
pzp: kjc
sld: fbk rrq hmb mlm
krg: crf pvq bcb klt
pms: qsr bgd zvf
lsp: nld hpj sdq rxl
nmk: dbb
hhq: rfd qfx snt
knj: vjt qfb bkk vhc dxv kmq
mlv: sfv
qmf: hrx
nld: kfr fdc
mxz: ptg lsp gvq fzc
ckg: czd hjl rlx cxn
qhp: tnr
knd: pff htq jmq qsr
qqq: lcj tnr
hgd: llk ghp rkt
bvl: txc cvc jvv drh
bpk: rcv mtz zkq bdl qcd
khv: kjc jfg kkl
jmm: hgq
rcq: fhh mlj bnd vfh
hlg: czv
xpj: ggk fkh
qss: slv gss
rmp: lsf jsr nvf
qhv: gxb
vpm: mdr
sdp: xzn ssx
mkf: bnl zxv fqp dzd
rrh: dpz
grk: kdj
fgk: tsz bzl kcb
cnn: rnt
rcc: hkf mkf gxl xql
nkk: pct
dgm: xlk jrg
tjx: djh zlq hbn
jzv: nxx
cxr: lbt bsh vcb cvs
tpt: ktq ncj qjr grh
hks: zjb ztc fqx
lvx: cnn
jtl: fql pdm
qbl: cnt
cln: zsp tcl sgn fdl
bvg: ckp tmt slx rkq dvg jzv kqr
snb: xpr lnk gqh srr
dbs: gnj gcd dpv kfg
pbh: hxf zhx
gvn: vpm flc
cqd: frn knh
qcp: hqz
pfr: tcs tcj
bjc: cpb cnt
lbx: zkj ssj gqm zsm
ddf: sld qkf cjs
thv: cvf xpt
rbc: mjp
vfg: xzc fzk
fvf: qtq ngg fgf grj
cdh: gpr fzq lcs
nfh: xgk bjd rxb
hbn: crm
vhz: qkt
kdj: jfg bnx xlq
cdf: vrf cpm blg gdn bkk kjp
vrb: mlz nlr
nhz: xzc bgm
jmx: nhb
qgr: bnd qvg
gst: ghm fqx bjp
zds: prk
xjr: sbr dfc lcs nts lvx
lpg: psr nrg jmm pqb
szc: zxs
hst: djv cjs
bfh: cnn tvd
qqf: dbf kkl gzk
jph: bgp kgc vrf dpq
hvk: gbx xdq
rfd: vmv vrr
xkv: pgk cjr
zxv: xng
nrr: dbb vgm
glr: lhx bzm lpj
vdg: ncj
gdn: nmm
jsm: khq
gcg: pct
sjf: qhk fdx lcs
cpf: dfc kgl
xjd: lzh crg lcq
jjd: qhv fqr gvx srl
ncm: jnp pvq jcr mjp
vvt: xcq
vsz: zrb mhs qlm xlk pql
ppm: gxb
cxp: hxm vmq
mrx: qtq vfx
pzs: pll
dnm: jrm cbm bgb ckh kvd
ntt: qhq dvm jxb fqh
brp: qgt pfh snl clv
hth: djv
zfs: qdk brv vhs jsn
bvm: pxx zmd
psd: dvg hsg hjk bvm
tfq: xqg fbv npv gbt
jnf: fqv zhx smd
gcr: smd
jns: tqs dvl bhg
xcr: fjc
dqv: hlk
gdf: jcs cpc rtd tlg jks
mzz: qhv rjs
fhz: lqg xdq bzz
ztk: jhc
jrt: rbv hdl grk ddx zvf
jhm: lfq gdx
hdk: ccv jkt txc
kgm: rlx mmt trk mlv
ftl: kfr psb pfc
jnp: mpn lqn
qgm: mpt kvq
dvg: ltk rtg
vkd: fjp rts pfh qfb ngx
hmv: dbf thv qll xgq
kfx: llt cvx plv hlg
jnb: mmt mvt hvm dqk
qkm: fgt hbl qdt gzb
fmt: bjp
fqh: flc
fvq: xkv sfh jsg qxt
mkh: pkz tpl snl mxc
fnk: gtp jtq lrr mdr
xcq: hbg
blc: bjd rjm tbj
nbv: djx pvm
pff: dzd
xlk: tbr
fjc: lvn xmq
hvq: jxp jkt
qbb: gzx phs txt tmc
ckh: nxs
nfx: mrx zfv hlm gzg npl
gbq: fqv htt mjt
fgt: pqm jqj khq
zbp: kcq pcs nhb pjv sbz
tzn: jxx zjx ktq gtp
srz: crz tnp mps
djc: vvm khc
vhs: njz djx lrf
qqr: ftm mkc
xvs: ksn sjd zhj
xbd: bpf
nlh: dhh bvg lhz
rls: mht szk
jqq: hks
zjx: lpj
jnj: znc kpq xpt
sgm: tlq brn rgz npx cpb
qsr: qqf rbc
fbq: jkn tfc mfm hmb
ggn: vdg
nnl: jsf tpv njx lvn
qdr: vkx mzx lfj bhl mpf sxr
blt: jpp cqd qfk slx
kkh: tfc vhc
kvq: fqx htq
fbk: dgc zsm
xdc: xjc nff llk qtg
bnl: tmc rhf
rfm: gcd hsx qvk
qvt: kdm zpj fgf
klt: lpq sqr kpc
ljk: zdz tfq ckp gdx
znc: bjp
cpv: hzh fkc qtv bmx
hjq: xrd crz gqn hqr
lkq: tpj slv xsx
sgn: mlz bfv vkx rrh rqj
bql: dcl ztc zpv ghs
xkk: dlv xdx
lqd: gqt
dkl: gbt dgc
fnx: zmq kpf dmf
xxg: fpr vdj hgq khq qgr
nvs: fmt mjd
gkd: rkq srl jtl mdx
dfv: xcd cgf
jcv: kcf mlp hhk rcv krd dkl tmd
kqb: xgk rlg mhs bnn znf
fdc: gcr bct dpq
csg: lcs
qzf: vth mlp fnx kvf khn qxf
sjd: rbc ccl
dss: kpf
vcb: kcb
jzc: npx gqm
gfz: tql
plm: mks tkx
kqp: fqr psr
fkc: zds fqh
nhm: hvz gzk qkn
jfc: lbq psn xvv hsg
bzz: cvc dzd
tcq: nnd
bqv: pdt bhk
hpj: gjx qxx
lkf: plm
slf: fjf hdk lfb fgf
bvp: ccv hlk
lnk: gqb zkp
psb: gcr
nps: ccl qgg mlk
ljf: ftr qgg bmx bgd
qnb: gqm nrg zdk
nbt: dzd sgc
srr: xpj kdm
mcd: csg rtg
ngc: mgg
mvz: fvk gxv cqd
tbf: drz
jtz: dmc ktq djt jsn
qrq: dhh kgl xlk pqb
hxx: rhs nhz dmd xpr
ttr: qqr lbc
qfb: mcd khj
xnl: xgq sdp fkx
cvf: qgz
gzx: gbx jxx
khn: hfn csm gcl ghj
pvr: sfr htt gmb
prk: zpv
cbd: kqq tqj fzc
zmd: jsg fnz
rvv: rgs
xmf: lrr
ptp: djx rhf
bpf: crg tql znc
pdt: mlk vsh
jmv: kbz rgs
hxh: nxx xdb sdq
kmr: qtp nkk bnx fzt
vsh: ftr rgd
lbc: csk xcq
frg: pnr kpd tkx jsn
kpp: lpq ghs
rxl: gdx lgt trz qmh
lsf: lcm ccs
cml: sgc
qbz: qzk csm
csf: stj mcb lbg mhp zlx jmk
cqm: jnf mfk tsb
ghs: nkj
zrx: ztc tnr lbz drh zxv
zcn: zlp ggg sqp qcp dpz hth rpc
gzg: bhg
pjb: qfb rmk tcz zkj
lnn: pbh jsm hxj
gzl: jfj chs vjk
msm: jrz qpp spj kfc knh
zfl: fkh qxd cgf jxk gpb kvq
fgf: pbb
gnv: cgp sql jcs jsm rkt
ghr: mrh srr kpd
bkq: jhc xzn
cqh: jxb cvf
bfk: npg
vgl: lmv hsx vfg glr
slx: vnc
ltv: kcb
lrf: ssp xrd bkq bzz ccs
lxr: pzp dfz
pvm: ltg czv
jmk: lfb
qhq: bzn crl kzb qkn
gcd: tnp
bnd: hbg
tfm: rgs
zvd: qtv csl
pdz: mqj ftm zll
zmm: rlj zgx lcm prv
krf: jcs rgs
pvj: tpv cld bbr
grh: xlq vkd nlm
xql: kcq cvf ddx
bgp: bvn zlp
dfz: crf
zdz: nsb rkt xbq mhs
mfs: xbd ldz nrc nkk
pbx: mmx qxd rpp ccv
pdp: hlc cmv gdx zxh
rgc: gfk bmx
mqx: qkt zmq rtb
zpg: xvq pdm npv xbq
jmq: mxc pzp tjb
pzq: csk rnt
gvf: bgt jmk tkx nrc
ftr: fqh qtx
cld: jzc dnj xvq
pjv: gds
pfs: zxs tfk vql ggl
plz: zkv xzs dgh dqk
kmk: zjx
hkc: sfh zrn mzz xmk
zmq: bkk grr
vnd: vhc zmd lbc tvb ghj
kfd: tfz vhc
xcd: cvc dsd
lbp: bxd jmx crm zxs
jfg: txj zjx
cts: pms ssf pqc
znf: tnt
fxn: hxp hjk kxr
rpm: hsx
tvd: vnv
dvn: plm mrx
fcl: nps lkj tnp gvn
nsq: fkh tbf lpj
kpd: lkj
djv: mnk
tsb: nck
hkt: kfg lkf dvn cbk
tvb: pzs
tch: vqs dxv
rrq: pqv
lvf: zdb bjc tts fxn
snt: djv cxn cnt
kqq: sqd
kvx: qcp lcs
nfq: fzk rhv rhf
tbj: nmc sqp vhz
bdh: bzl gcr bnd
rqh: cjs qzk
bdl: rjs
tlq: snt zhx
hgs: gcd pqn pkc cmz kpq
xqh: khf lgt nxx
mjt: pnv
npg: bcv
nrn: rlg
hlm: frg dfz xvs lrq
vns: gkq bmq bsh zll
cfj: rhc ldz pxr grk
jrr: plm vjp zkp grj
scx: lml dnj
jgt: kvx rbr zzs kfd
dbb: tnt
hkp: mpt ggk gfx jsn sbz
lnp: vkr jsf qvn dss
tgp: rqh
rsj: lgt
vhr: lbz
fkx: hkf crz qtv
sxv: bpq ssj khc kqq
gzk: hmx
lbq: smd
pmj: jdg grr dxk bfd
kfg: jfj
gkj: mnp dqk hxf
ztj: prk ngc pss jxb qjg
mht: hfz zgx
vnl: fjm rbc
mlk: txc pvm
tmx: mfg kzp txj drh
qjd: qtd fqh ndd bgb
mnr: lcj ggn
cff: kmk lkf lqd kkl xdq klt
bvb: jmm vhz mvz sfr lvx
psv: pmp
lmf: rpm dsd zxv fkx
gnj: hlk
txv: rkt
lbz: hvz zfv
ncg: zmb bld fcd qbf
kbz: nxx
bxd: lzj bbm kzn dml
lcf: vfv vth kcr qmf
fgb: sfh prz
jct: kfd jkx znf cjg pdm
cft: ccs gmf
rcv: tpv
pxb: xmk bdl tsb rbr xvz
dtp: pll rnt
hdl: bmc zdc
fcd: dvl txc bqh
sdq: bsh
pkv: jck ddx pcs grb
rbl: nhm mdl gmq qhp
cbh: gfz dqv rhv lbk qvx
xqk: pmp fzt
mxm: kcb scx sld jnd
njl: tgv fqx cml zkp
qvp: ssf dfv lqg kzb
bft: tpv pbh rxl cmv
spj: jjk bkx jjl gvq
snl: hvq bzn
gqb: htx
jxx: ndd
lrq: ccv
pqm: qbl tts
hmj: gjv
hkf: xqk
lcm: ccl
mhc: cfc
mnk: htt
npv: pzs fbv jmv
tfc: xrj fnz
jkv: zhj vpm dlv str
mpp: lvn cvs
pkc: xkk lpj xqd
ksv: qnb cdh rtd
zrb: nff fnz
sqp: dhm
tjr: xsx dfd
vkb: vkr tmd hcd
lmq: mlp dfc gmb
xrg: qgr kxk lgl
jmj: nbv dfv hgk mxc
qqv: zll tsb fpr
lmc: vgd llv nqq qjg
ghd: dqp tlq gbl jcd
cmq: bfk dfz nhb vlf
fqr: mnp
xjc: pfk
lvv: pct zjx
rtb: jcs mqj
kxp: pfk bxv qfx mtg
rgz: qqv hxh tfj
pcs: djt lcj
ggq: vxf bqb fpr gcs
fdx: nmm
jhz: zjx qlh dbf
dvk: ggh fvv nfh
tfz: vpp fgk sqd
ntr: mqm rhf hbn rmp kzb
sbz: mjp
zjk: kzp xpt
nxx: rmk
ghj: qtg dtp
tfj: bvn
xtz: cqh
lqs: gqb xtz
hqr: xdx trg
hnz: pvq kfg rph vmq khg
hrr: dmd dml
xnm: qgm
ngv: zpl qfx bkm csb ncf
zpl: npx cxq
lhx: gqt cxp gfx
jts: qss nrn vrf jsm
gqm: bzg
mnc: hlg ghm gqn
zxh: bfv zpd lfj
sgs: szp rqj qxt
rbr: gjx xcr
lbt: gss tfj hhk
pct: hsx
kds: bnn sxv vnv
dpz: vjt tsz
ztc: czv
btk: kcr bkk vjt
hfn: dss pfk
pfh: qgz
ckp: sgs mnk
ppr: dvk ghp hhk fpq sdz
jhf: mzt ngx hcn mkk
gfb: kgc
pvs: kkb glj qbb xpr
fsm: llb dfz kpp
txt: xqd grb mtf htq vgd
ncc: crl cqh tmc mhc ssp
zgn: zhl jxb hdl zgx
jtq: hdl
rhv: hzh nvf
vln: brn hqz tsz vnv
vls: qbh lgn fpk bmq fgb
kkm: kzn rts dqv
qxd: khv lqd
pcb: dfd vmv
vlr: lrq csq ghr rhf
bld: mhc llb
mlj: rkt tvb
qxt: ght
pgn: tjr kjp kds kpf
ktq: dtq
mjd: lzr lls jrm
mtb: kjc vjp zlq vfc ttl
hbf: rgc hbn kzn
rgq: xmf fts mgg gtp
cxk: bqh
rhc: fkc
gnf: mtx qgr mtz khc
bxl: mhc rgc ddx rpm
qzx: zjk mnc zfl zqm
vtj: hdl fnm fqh
lzn: bzg tqj
xnj: csl lhl
hnh: dfz tmc qgz zjn
frf: bnn kxr fpr
jvv: mkk mxc kpp
dnb: zlp nlr
vfh: qxt csb xsk mcd srf
fzp: vhr vfc lzh cvg
cfx: kpn pnc
kvd: bgm
jvd: nml bfb cxn jks
bcq: rlx
mnp: hbg
gqs: hbn lls chs ndp
kqn: mlv mnk vjv
rnt: bgp fql
ngs: cxl hxf vfh ddh
bhk: jfg vjk bzm
txq: mbp lsf bcb dlv
bbb: ltv frf pqv gvq jnf
cgr: pbs rjs rxb mpf
ngg: tgv
lgj: mfg bcv szc
ptv: mtz qqt lbq ght
vmf: kjp lfm dzg rlg
mjb: dml xsh qtq vjk
hvz: szk
rgp: fmt cbt cmz rpt
prv: bfk
hbl: xsx krf dfd
fvb: vmx hxj lpg
djr: sdq gpr
hxf: pnc slv xbq
tlk: gfz ftf djp
cvm: xmk qmf fhv tmd
xtl: gds
jjv: gnj grk kkm lqn bmc crg
ztp: nxs xdq pkl
lkr: sbr cqm tch fdx
cmz: rjl
phs: hjb bvp bkq
rbv: xzz xph lxr
mks: kpc
xpk: bgm ttp tcq
krq: dvn bqv zlx gmq
slt: mmt jlx dpq
jxk: prv gzk
hjl: bjd frs xrq
snq: fzt csq pzp txj
mcb: fjp jxx jxp
hvm: gbl lbx ncf
ncf: zgd lgp
gxl: gzk kdm
gpb: gcd
dsl: dlv bnx nvs
rgf: dvl ndp rpt nbt xgq
frs: cjs qnb
nts: vrr jkn qmf
csl: zjx
szk: kmk
pqn: nbv stk ngg
cbm: trs
fmv: mxc fzn fpc
ndq: gvn vdg dxz gcg
khc: vjv
zsm: vdh
lrr: xpr
qlj: zch
ftm: kmq tnt
fjn: xtl hqq cmz
hhk: sqd
jks: csc
pqj: cjp fsv cft kkb
bsf: bzl tvd zch cvs
xhd: qll gbx vnl ggn xpj
ltk: szb tcs
lqn: lhl bzm
bqc: npx kbz mpp
vfc: jfj
pkb: rgd
cgq: zfl clv sdd lhx zfr
vrk: bgt gzg zds fkc
sql: tjr lhz
mlp: zgd srf
cpr: gcg nnd sqr pff
jcs: pdm
qpp: kkp
ccs: jfj
mqj: lvn knh
fqs: mfm dzg grr
hqz: cjg
xgx: vnv tpj hst qfb qlj kbz
bkx: lfj htt
vtb: jcz slt vrb kqp
xsh: tcq hdk
mfx: hxm
nxj: dqd tvd jmv vvd brh tts
fsv: hhv
tmt: fqv fql lgt vkj
chs: hrr rgl
cpm: kcf jkn vfh